Load=[MapProperties]

EndLoad=[MapProperties]

Load=[tile_layer]

Load=[NullTile]
[---]

Load=[Motion]
[2,0:Static]

Load=[speed_modifier]
[1,0:0.5][2,0:0.25]

Load=[TileSheet]
[back_tile_sheet_1]

Load=[StartLayer]

[---][---][---][---][---][---][---][---][---][---][---][---][---][---][---][---][---][---][---][---][---][---]
[---][---][---][---][---][---][---][---][---][---][---][---][---][---][---][---][---][---][---][---][---][---]
[---][---][---][---][---][---][---][---][---][---][---][---][---][---][---][---][---][---][---][---][---][---]
[---][---][---][---][---][---][---][---][---][---][---][---][---][---][---][---][---][---][---][---][---][---]
[---][---][---][---][---][---][---][1,0][---][---][1,0][---][---][---][---][---][---][---][---][---][---][---]
[---][---][---][---][---][---][---][---][---][---][---][---][---][---][---][---][---][---][---][---][---][---]
[---][---][---][---][---][---][---][---][---][---][---][---][---][---][---][---][---][---][---][---][---][---]
[---][---][---][---][---][---][---][---][---][---][---][---][---][---][---][---][---][---][---][---][---][---]
[---][---][---][---][---][---][---][---][---][---][---][---][---][---][---][---][---][---][---][---][---][---]
[---][---][---][---][---][---][---][---][---][---][---][---][---][---][---][---][---][---][---][---][---][---]

Load=[EndLayer]

EndLoad=[tile_layer]

Load=[block_layer]

Load=[NullTile]
[---]

Load=[Motion]
[2,0:Static]

Load=[TileSheet]
[block_tile_sheet_1]

Load=[StartLayer]

[---][---][---][---][---][---][---][---][---][---][---][---][---][---][---][---][---][---][---][---][---][---]
[---][---][---][---][---][---][---][---][---][---][---][---][---][---][---][---][---][---][---][---][---][---]
[---][---][---][---][---][---][---][---][---][---][---][---][---][---][---][---][---][---][---][---][---][---]
[---][---][---][---][---][---][---][---][---][---][---][---][---][---][---][---][---][---][---][---][---][---]
[---][---][---][---][---][---][---][---][---][---][2,0][---][---][---][---][---][---][---][---][---][---][---]
[---][---][---][---][---][---][---][---][---][---][---][---][---][---][---][---][---][---][---][---][---][---]
[---][---][---][---][---][---][---][---][---][---][---][---][---][---][---][---][---][---][---][---][---][---]
[2,0][2,0][2,0][2,0][2,0][2,0][2,0][2,0][2,0][2,0][2,0][2,0][2,0][2,0][2,0][2,0][2,0][2,0][2,0][2,0][2,0][2,0]
[---][---][---][---][---][---][---][---][---][---][---][---][---][---][---][---][---][---][---][---][---][---]
[---][---][---][---][---][---][---][---][---][---][---][---][---][---][---][---][---][---][---][---][---][---]

Load=[EndLayer]

EndLoad=[block_layer]